wwwwwwwwwwwwwwwwwwwwwww
w.....................w
w.....................w
wnb.b.m.m.....m.m.b.b.w
wm.m.m.m.m...m.m.m.m.nw
wnm.m.m.m.m.m.m.m.m.m.w
wm.m.m.m.m.m.m.m.m.m.nw
wb.b.b.b.b.nb.b.b.b.b.w
w.....................w
w.....................w
w.....................w
w.....................w
w.....................w
w.....................w
w.....................w
w.....................w
w.....................w
w.....................w
w..........A..........w
w.....................w