wwwwwwwwwwwwwwwwwwwwwwwwwwwwwww
w......w....w....w....w.......w
w......w..u.w....w$.u.w..d....w
w......w$..$w.........www....ww
w..Ap..w..p.w$.p.w..p...w...bgw
w................w....www....ww
w......w$..$w....w....w.......w
w..d...w....w..d.w$...w....u..w
w......w....w....w....w.......w
wwwwwwwwwwwwwwwwwwwwwwwwwwwwwww
