wwwwwwwwwwwwwwwwwwwwwwwwwwwwwww
l.............................r
w.......p$w$$$$p$$$$w$p.......w
w.......$ww$$$$p$$$$ww$....w..w
wp..A...$ww$$$$$$$$$ww$...wgw.w
w.......$ww$$$$$$$$$ww$....w..w
w.......$ww$$$$p$$$$ww$.......w
w.......p$w$$$$p$$$$w$p.......w
l.............................r
wwwwwwwwwwwwwwwwwwwwwwwwwwwwwww
